4444222222
4 4 2    2
4 4 222 22
4   2    2
3 335 5 55
3   5 5  5
3 3 555 55
3 3 1    1
3 3      1
3333111111