5555444444
5 5 4    4
5 5 4444 4
5   4    4
5 5 3 3333
1   3 3  3
1 1 3 3 33
1 1 2 2  2
1 1      2
1112222222